##########
#....F...#
#..O.....#
#........#
#....S...#
##########