###################
#   #F            #
#   ####          #
#       #####     #
#  #              #
#  # S            #
###################