##########
#....F...#
#........#
#........#
#....S...#
##########