############
#  # F   ###
#  #####   #
#          #
#  ####    #
#    S#    #
############