#########################
#                       #
#                       #
#                       #
#        SSSSS          #
#        SSSSS          #
#        SSSSS          #
#        SSSSS          #
#        SSSSS          #
#                       #
#                       #
#                       #
#                       #
#                       #
#                       #
#                       #
#                       #
#                       #
#                       #
#          F            #
#                       #
#                       #
#                       #
#                       #
#########################