##############################
####           ##            #
##S#  #######  ## S          #
## #F       #####   ######   #
#  #   #    #      ##    #   #
# ######  ###      #     #   #
# ######  #        #######   #
# ######  ######   #######   #
#                            #
#       ###     ###          #
#     ### ### ### ###        #
#    ##     ###     ##       #
#     ##           ##        #
#      ##         ##         #
#       ##       ##          #
#        ##     ##   ###     #
#         ##   ##    ###     #
#          ## ##             #
#           ###              #
#            #   S           #
##############################